##################################################
###                                             E#
####################### ##                       #
##                      #### #####################
## #################### #### ##                 ##
## ####################################### #######
##                                            ####
### ###########                 ##########    ####
###           #                 ########## #######
###############                            #######
#                               ########## #######
# #############                 ########## #######
# #           # ########### ###########    #######
# # #         # ########### ########### ##########
# # ###########         ###                  #####
# # ################### ################     #####
# #                     ################     #####
#S################################################
##################################################